alias .='open .'
alias ..='cd ..'
alias ...='cd ../..'
alias ....='cd ../../..'
alias .....='cd ../../../..'
alias G=git
alias G..='cd "$(git-root || print .)"'
alias 'G?'='git-alias-lookup /Users/davesnx/.zim/modules/git'
alias GCO='GCo $(GCl)'
alias GCT='GCt $(GCl)'
alias GCa='git add $(GCl)'
alias GCe='git mergetool $(GCl)'
alias GCl='git --no-pager diff --diff-filter=U --name-only'
alias GCo='git checkout --ours --'
alias GCt='git checkout --theirs --'
alias GR='git remote'
alias GRS='git remote set-url'
alias GRa='git remote add'
alias GRl='git remote --verbose'
alias GRm='git remote rename'
alias GRp='git remote prune'
alias GRs='git remote show'
alias GRu='git remote update'
alias GRx='git remote rm'
alias GS='git submodule'
alias GSI='git submodule update --init --recursive'
alias GSa='git submodule add'
alias GSf='git submodule foreach'
alias GSi='git submodule init'
alias GSl='git submodule status'
alias GSm=git-submodule-move
alias GSs='git submodule sync'
alias GSu='git submodule update --remote'
alias GSx=git-submodule-remove
alias GW='git worktree'
alias GWX='git worktree remove --force'
alias GWa='git worktree add'
alias GWl='git worktree list'
alias GWm='git worktree move'
alias GWp='git worktree prune'
alias GWx='git worktree remove'
alias Gb='git branch'
alias GbG='git-branch-remote-tracking gone | xargs -r git branch --delete --force'
alias GbL='git branch --all -vv'
alias GbM='git branch --move --force'
alias GbR='git branch --force'
alias GbS='git show-branch --all'
alias GbX='git-branch-delete-interactive --force'
alias Gbc='git checkout -b'
alias Gbd='git checkout --detach'
alias Gbl='git branch -vv'
alias Gbm='git branch --move'
alias Gbs='git show-branch'
alias Gbu='git branch --unset-upstream'
alias Gbx=git-branch-delete-interactive
alias Gc='git commit --verbose'
alias GcA='git commit --verbose --patch'
alias GcF='git commit --verbose --amend'
alias GcO='git checkout --patch'
alias GcP='git cherry-pick --no-commit'
alias GcR='git reset "HEAD^"'
alias GcS='git commit --verbose -S'
alias GcU='git commit --squash'
alias Gca='git commit --verbose --all'
alias Gcf='git commit --amend --reuse-message HEAD'
alias Gcm='git commit --message'
alias Gco='git checkout'
alias Gcp='git cherry-pick'
alias Gcr='git revert'
alias Gcs='git show --pretty=format:"${_git_log_fuller_format}"'
alias Gcu='git commit --fixup'
alias Gcv='git verify-commit'
alias Gd='git ls-files'
alias Gdc='git ls-files --cached'
alias Gdi='git status --porcelain --short --ignored | sed -n "s/^!! //p"'
alias Gdk='git ls-files --killed'
alias Gdm='git ls-files --modified'
alias Gdu='git ls-files --other --exclude-standard'
alias Gdx='git ls-files --deleted'
alias Gf='git fetch'
alias Gfc='git clone'
alias Gfm='git pull --no-rebase'
alias Gfr='git pull --rebase'
alias Gfu='git pull --ff-only --all --prune'
alias Gg='git grep'
alias GgL='git grep --files-without-match'
alias Ggi='git grep --ignore-case'
alias Ggl='git grep --files-with-matches'
alias Ggv='git grep --invert-match'
alias Ggw='git grep --word-regexp'
alias GiA='git add --patch'
alias GiD='git diff --no-ext-diff --cached --word-diff'
alias GiR='git reset --patch'
alias GiX='git rm --cached -rf'
alias Gia='git add'
alias Gid='git diff --no-ext-diff --cached'
alias Gir='git reset'
alias Giu='git add --update'
alias Gix='git rm --cached -r'
alias Gl='git log --topo-order --pretty=format:"${_git_log_fuller_format}"'
alias GlG='git log --graph --pretty=format:"${_git_log_oneline_medium_format}"'
alias GlO='git log --topo-order --pretty=format:"${_git_log_oneline_medium_format}"'
alias Glc='git shortlog --summary --numbered'
alias Gld='git log --topo-order --stat --patch --pretty=format:"${_git_log_fuller_format}"'
alias Glf='git log --topo-order --stat --patch --follow --pretty=format:"${_git_log_fuller_format}"'
alias Glg='git log --graph --pretty=format:"${_git_log_oneline_format}"'
alias Glo='git log --topo-order --pretty=format:"${_git_log_oneline_format}"'
alias Glr='git reflog'
alias Gls='git log --topo-order --stat --pretty=format:"${_git_log_fuller_format}"'
alias Glv='git log --topo-order --show-signature --pretty=format:"${_git_log_fuller_format}"'
alias Gm='git merge'
alias GmC='git merge --no-commit'
alias GmF='git merge --no-ff'
alias GmS='git merge -S'
alias Gma='git merge --abort'
alias Gmc='git merge --continue'
alias Gmt='git mergetool'
alias Gmv='git merge --verify-signatures'
alias Gp='git push'
alias GpA='git push --all && git push --tags'
alias GpF='git push --force'
alias Gpa='git push --all'
alias Gpc='git push --set-upstream origin "$(git-branch-current 2>/dev/null)"'
alias Gpf='git push --force-with-lease'
alias Gpp='git pull origin "$(git-branch-current 2>/dev/null)" && git push origin "$(git-branch-current 2>/dev/null)"'
alias Gpt='git push --tags'
alias Gr='git rebase'
alias GrS='git rebase --exec "git commit --amend --no-edit --no-verify -S"'
alias Gra='git rebase --abort'
alias Grc='git rebase --continue'
alias Gri='git rebase --interactive --autosquash'
alias Grs='git rebase --skip'
alias Gs='git stash'
alias GsS='git stash save --patch --no-keep-index'
alias GsX=git-stash-clear-interactive
alias Gsa='git stash apply'
alias Gsd='git stash show --patch --stat'
alias Gsl='git stash list'
alias Gsp='git stash pop'
alias Gsr=git-stash-recover
alias Gss='git stash save --include-untracked'
alias Gsu='git stash show --patch | git apply --reverse'
alias Gsw='git stash save --include-untracked --keep-index'
alias Gsx='git stash drop'
alias Gt='git tag'
alias Gts='git tag --sign'
alias Gtv='git verify-tag'
alias Gtx='git tag --delete'
alias GwC='git clean -d --force'
alias GwD='git diff --no-ext-diff --word-diff'
alias GwM='git mv -f'
alias GwR='git reset --hard'
alias GwS='git status'
alias GwX='git rm -rf'
alias Gwc='git clean --dry-run'
alias Gwd='git diff --no-ext-diff'
alias Gwm='git mv'
alias Gwr='git reset --soft'
alias Gws='git status --short'
alias Gwx='git rm -r'
alias _cat='command cat'
alias _find='command find'
alias _kill='command kill'
alias _top='command top'
alias airport=/System/Library/PrivateFrameworks/Apple80211.framework/Versions/Current/Resources/airport
alias c=code
alias cat=bat
alias cfg='code ${DOTFILES_PATH}'
alias chrome='/Applications/Google\ Chrome.app/Contents/MacOS/Google\ Chrome'
alias chromekill='ps ux | grep '\''[C]hrome Helper --type=renderer'\'' | grep -v extension-process | tr -s '\'' '\'' | cut -d '\'' '\'' -f2 | xargs kill'
alias cl=clear
alias cleanup='_find . -type f -name '\''*.DS_Store'\'' -ls -delete'
alias copy=pbcopy
alias d=docker
alias dc='${DOTFILES_PATH}/bin/docker/connect'
alias df='df -h'
alias dps='docker run --rm -ti -v /var/run/docker.sock:/var/run/docker.sock quay.io/vektorlab/ctop:latest'
alias du='du -h'
alias dumpast='source ${DOTFILES_PATH}/bin/ocaml/dumpast'
alias e=esy
alias eachdir='. eachdir'
alias egrep='egrep --color=auto'
alias emptytrash='sudo rm -rfv /Volumes/*/.Trashes; sudo rm -rfv ~/.Trash; sudo rm -rfv /private/var/log/asl/*.asl; sqlite3 ~/Library/Preferences/com.apple.LaunchServices.QuarantineEventsV* '\''delete from LSQuarantineEvent'\'
alias export=' export'
alias fgrep='fgrep --color=auto'
alias find=fd
alias flush='dscacheutil -flushcache && killall -HUP mDNSResponder'
alias fly='/${HOME}/.fly/bin/flyctl'
alias ga=forgit::add
alias gc='git checkout'
alias gcl='git clone'
alias gd=forgit::diff
alias get='wget --continue --progress=bar --timestamping'
alias gf='git fetch'
alias gitignore=forgit::ignore
alias gl=forgit::log
alias globurl='noglob urlglobber '
alias gm='git commit -m'
alias gma='git commit --amend'
alias gp='git push'
alias gpl='git pull'
alias grep='grep --color=auto'
alias gs='git status -s'
alias h='history 1'
alias hd='head -n 1'
alias hosts='code /etc/hosts'
alias httpdump='sudo tcpdump -i en1 -n -s 0 -w - | grep -a -o -E "Host\: .*|GET \/.*"'
alias ifactive='ifconfig | pcregrep -M -o '\''^[^\t:]+:([^\n]|\n\t)*status: active'\'
alias ip='dig +short myip.opendns.com @resolver1.opendns.com'
alias ips='ifconfig -a | grep -o '\''inet6\? \(addr:\)\?\s\?\(\(\([0-9]\+\.\)\{3\}[0-9]\+\)\|[a-fA-F0-9:]\+\)'\'' | awk '\''{ sub(/inet6? (addr:)? ?/, ""); print }'\'
alias kill=fkill
alias l='exa --group-directories-first -al --no-time'
alias lc='lt -c'
alias ld='ls -D'
alias listen='lsof -n | grep LISTEN'
alias lk='ll -Sr'
alias ll='ls -lh'
alias lm='l | less'
alias localip='ipconfig getifaddr en0'
alias lr='ll -R'
alias ls='exa --group-directories-first -alh --octal-permissions'
alias lscleanup='/System/Library/Frameworks/CoreServices.framework/Frameworks/LaunchServices.framework/Support/lsregister -kill -r -domain local -domain system -domain user && killall Finder'
alias lt='ll -tr'
alias m=make
alias main='git checkout main'
alias map='xargs -n1'
alias master='git checkout master'
alias ml2re='source ${DOTFILES_PATH}/bin/ocaml/ml2re'
alias my=mycli
alias n=npm
alias o=oni2
alias p=pnpm
alias paste=pbpaste
alias path='echo -e ${PATH//:/\\n}'
alias pg=pgcli
alias port='source ${DOTFILES_PATH}/bin/system/port_owner'
alias privateip=localip
alias pumpitup='osascript -e '\''set volume output volume 100'\'
alias q=query-json
alias quit=exit
alias r=' source ${DOTFILES_PATH}/bin/scripts'
alias re2ml='source ${DOTFILES_PATH}/bin/ocaml/re2ml'
alias reload='exec ${SHELL} -l'
alias run-help=man
alias sniff='sudo ngrep -d '\''en1'\'' -t '\''^(GET|POST) '\'' '\''tcp and port 80'\'
alias stashl='${DOTFILES_PATH}/bin/git-extras/stash-list'
alias stfu='osascript -e '\''set volume output muted true'\'
alias sudo='sudo '
alias t=itomate
alias testzsh='TIMEFMT=$'\''real %E\tuser %U\tsys %S'\''; repeat 10 {time zsh -i -c exit}'
alias timer='echo "Timer started. Stop with Ctrl-D." && date && time cat && date'
alias tl='command tail -n 1'
alias top=htop
alias uuid=' uuidgen | tr '\''[:upper:]'\'' '\''[:lower:]'\'
alias week='date +%V'
alias which-command=whence
alias x=dum
alias y=yarn
